ba	pɑ
pa	pʰɑ
ma	mɑ
fa	fɑ
da	tɑ
ta	tʰɑ
na	nɑ
la	lɑ
za	tsɑ
ca	tsʰɑ
sa	sɑ
zha	tʂɑ
cha	tʂʰɑ
sha	ʂɑ
ga	kɑ
ka	kʰɑ
ha	xɑ
a	ɑ
bo	po
po	pʰo
mo	mo
fo	fo
o	o
bai	pai
pai	pʰai
mai	mai
dai	tai
tai	tʰai
nai	nai
lai	lai
zai	tsai
cai	tsʰai
sai	sai
zhai	tʂai
chai	tʂʰai
shai	ʂai
gai	kai
kai	kʰai
hai	xai
ai	ai
bang	pɑŋ
pang	pʰɑŋ
mang	mɑŋ
fang	fɑŋ
dang	tɑŋ
tang	tʰɑŋ
nang	nɑŋ
lang	lɑŋ
zang	tsɑŋ
cang	tsʰɑŋ
sang	sɑŋ
zhang	tʂɑŋ
chang	tʂʰɑŋ
shang	ʂɑŋ
rang	ʐɑŋ
gang	kɑŋ
kang	kʰɑŋ
hang	xɑŋ
ang	ɑŋ
beng	pəŋ
peng	pʰəŋ
meng	məŋ
feng	fəŋ
deng	təŋ
teng	tʰəŋ
neng	nəŋ
leng	ləŋ
zeng	tsəŋ
ceng	tsʰəŋ
seng	səŋ
zheng	tʂəŋ
cheng	tʂʰəŋ
sheng	ʂəŋ
reng	ʐəŋ
geng	kəŋ
keng	kʰəŋ
heng	xəŋ
eng	əŋ
me	mə
de	tə
te	tʰə
ne	nə
le	lə
ze	tsə
ce	tsʰə
se	sə
zhe	tʂə
che	tʂʰə
she	ʂə
re	ʐə
ge	kə
ke	kʰə
he	xə
e	ə
zi	tsz̩
ci	tsʰz̩
si	sz̩
zhi	tʂʐ̩
chi	tʂʰʐ̩
shi	ʂʐ̩
ri	ʐ̩
er	əɻ
bei	pɛi
pei	pʰɛi
mei	mɛi
fei	fɛi
dei	tɛi
nei	nɛi
lei	lɛi
zei	tsɛi
zhei	tʂɛi
shei	ʂɛi
gei	kɛi
kei	kʰɛi
hei	xɛi
ei	ɛi
bao	pɑɔ
pao	pʰɑɔ
mao	mɑɔ
dao	tɑɔ
tao	tʰɑɔ
nao	nɑɔ
lao	lɑɔ
zao	tsɑɔ
cao	tsʰɑɔ
sao	sɑɔ
zhao	tʂɑɔ
chao	tʂʰɑɔ
shao	ʂɑɔ
rao	ʐɑɔ
gao	kɑɔ
kao	kʰɑɔ
hao	xɑɔ
ao	ɑɔ
pou	pʰou
mou	mou
fou	fou
dou	tou
tou	tʰou
nou	nou
lou	lou
zou	tsou
cou	tsʰou
sou	sou
zhou	tʂou
chou	tʂʰou
shou	ʂou
rou	ʐou
gou	kou
kou	kʰou
hou	xou
ou	ou
ban	pan
pan	pʰan
man	man
fan	fan
dan	tan
tan	tʰan
nan	nan
lan	lan
zan	tsan
can	tsʰan
san	san
zhan	tʂan
chan	tʂʰan
shan	ʂan
ran	ʐan
gan	kan
kan	kʰan
han	xan
an	an
ben	pən
pen	pʰən
men	mən
fen	fən
den	tən
nen	nən
zen	tsən
cen	tsʰən
sen	sən
zhen	tʂən
chen	tʂʰən
shen	ʂən
ren	ʐən
gen	kən
ken	kʰən
hen	xən
en	ən
bang	pɑŋ
pang	pʰɑŋ
mang	mɑŋ
fang	fɑŋ
dang	tɑŋ
tang	tʰɑŋ
nang	nɑŋ
lang	lɑŋ
zang	tsɑŋ
cang	tsʰɑŋ
sang	sɑŋ
zhang	tʂɑŋ
chang	tʂʰɑŋ
shang	ʂɑŋ
rang	ʐɑŋ
gang	kɑŋ
kang	kʰɑŋ
hang	xɑŋ
ang	ɑŋ
beng	pəŋ
peng	pʰəŋ
meng	məŋ
feng	fəŋ
deng	təŋ
teng	tʰəŋ
neng	nəŋ
leng	ləŋ
zeng	tsəŋ
ceng	tsʰəŋ
seng	səŋ
zheng	tʂəŋ
cheng	tʂʰəŋ
sheng	ʂəŋ
reng	ʐəŋ
geng	kəŋ
keng	kʰəŋ
heng	xəŋ
eng	əŋ
dong	toŋ
tong	tʰoŋ
nong	noŋ
long	loŋ
zong	tsoŋ
cong	tsʰoŋ
song	soŋ
zhong	tʂoŋ
chong	tʂʰoŋ
rong	ʐoŋ
gong	koŋ
kong	kʰoŋ
hong	xoŋ
bi	pi
pi	pʰi
mi	mi
di	ti
ti	tʰi
ni	ni
li	li
ji	tɕi
qi	tɕʰi
xi	ɕi
yi	ji
lia	lia
jia	tɕia
qia	tɕʰia
xia	ɕia
ya	ja
biao	piɑɔ
piao	pʰiɑɔ
miao	miɑɔ
diao	tiɑɔ
tiao	tʰiɑɔ
niao	niɑɔ
liao	liɑɔ
jiao	tɕiɑɔ
qiao	tɕʰiɑɔ
xiao	ɕiɑɔ
yao	jɑɔ
bie	piɛ
pie	pʰiɛ
mie	miɛ
die	tiɛ
tie	tʰiɛ
nie	niɛ
lie	liɛ
jie	tɕiɛ
qie	tɕʰiɛ
xie	ɕiɛ
ye	jɛ
miu	miu
diu	tiu
niu	niu
liu	liu
jiu	tɕiu
qiu	tɕʰiu
xiu	ɕiu
you	jɔu
bian	piɛn
pian	pʰiɛn
mian	miɛn
dian	tiɛn
tian	tʰiɛn
nian	niɛn
lian	liɛn
jian	tɕiɛn
qian	tɕʰiɛn
xian	ɕiɛn
yan	jɛn
bin	pɪn
pin	pʰɪn
min	mɪn
nin	nɪn
lin	lɪn
jin	tɕɪn
qin	tɕʰɪn
xin	ɕɪn
yin	jɪn
niang	niɑŋ
liang	liɑŋ
jiang	tɕiɑŋ
qiang	tɕʰiɑŋ
xiang	ɕiɑŋ
yang	jɑŋ
bing	pɪŋ
ping	pʰɪŋ
ming	mɪŋ
ding	tɪŋ
ting	tʰɪŋ
ning	nɪŋ
ling	lɪŋ
jing	tɕɪŋ
qing	tɕʰɪŋ
xing	ɕɪŋ
ying	jɪŋ
jiong	tɕioŋ
qiong	tɕʰioŋ
xiong	ɕioŋ
yong	joŋ
bu	pu
pu	pʰu
mu	mu
fu	fu
du	tu
tu	tʰu
nu	nu
lu	lu
zu	tsu
cu	tsʰu
su	su
zhu	tʂu
chu	tʂʰu
shu	ʂu
ru	ʐu
gu	ku
ku	kʰu
hu	xu
wu	wu
zhua	tʂuɑ
chua	tʂʰuɑ
shua	ʂuɑ
rua	ʐuɑ
gua	kuɑ
kua	kʰuɑ
hua	xuɑ
wa	wɑ
duo	tuɔ
tuo	tʰuɔ
nuo	nuɔ
luo	luɔ
zuo	tsuɔ
cuo	tsʰuɔ
suo	suɔ
zhuo	tʂuɔ
chuo	tʂʰuɔ
shuo	ʂuɔ
ruo	ʐuɔ
guo	kuɔ
kuo	kʰuɔ
huo	xuɔ
wo	wɔ
zhuai	tʂuai
chuai	tʂʰuai
shuai	ʂuai
guai	kuai
kuai	kʰuai
huai	xuai
wai	wai
dui	tui
tui	tʰui
zui	tsui
cui	tsʰui
sui	sui
zhui	tʂui
chui	tʂʰui
shui	ʂui
rui	ʐui
gui	kui
kui	kʰui
hui	xui
wei	wɛi
duan	tuan
tuan	tʰuan
nuan	nuan
luan	luan
zuan	tsuan
cuan	tsʰuan
suan	suan
zhuan	tʂuan
chuan	tʂʰuan
shuan	ʂuan
ruan	ʐuan
guan	kuan
kuan	kʰuan
huan	xuan
wan	wan
dun	tun
tun	tʰun
lun	lun
zun	tsun
cun	tsʰun
sun	sun
zhun	tʂun
chun	tʂʰun
shun	ʂun
run	ʐun
gun	kun
kun	kʰun
hun	xun
wen	wən
zhuang	tʂuɑŋ
chuang	tʂʰuɑŋ
shuang	ʂuɑŋ
guang	kuɑŋ
kuang	kʰuɑŋ
huang	xuɑŋ
wang	wɑŋ
weng	wəŋ
nü	ny
lü	ly
ju	tɕy
qu	tɕʰy
xu	ɕy
yu	y
nüe	nyɛ
lüe	lyɛ
jue	tɕyɛ
que	tɕʰyɛ
xue	ɕyɛ
yue	jyɛ
juan	tɕyan
quan	tɕʰyan
xuan	ɕyan
yuan	jyan
jun	tɕyn
qun	tɕʰyn
xun	ɕyn
yun	jyn
